111111111111111111111111111111111111111111111111
1LLLLLLLLLLLLLLLLLLLLLLLLLLLLLLLLLLLLLLLLLLLLLL1
1LLLLLLLLLLLLLLLLLLLLLLLLLLLLLLLLLLLLLLLLLLLLLL1
1LLLLLLLLLLLLLLLLLLLLLLLLLLLLLLLLLLLLLLLLLLLLLL1
1LLLLLLLLLLLLLLLLLLLLLLLLLLLLLLLLLLLLLLLLLLLLLL1
1LLLLLLLLLLLLLLLLLL000000000000LLLLLLLLLLLLLLL1
1LLLLLLLLLLLLLLLLLL000000000000LLLLLLLLLLLLLLL1
1LLLLLLLLLLLLLLLLLL000009000000LLLLLLLLLLLLLLL1
1LLLLLLLLLLLLLLLLLL000000000000LLLLLLLLLLLLLLL1
1LLLLLLLLLLLLLLLLLL000000000000LLLLLLLLLLLLLLL1
1LLLLLLLLLLLLLLLLLLLLL000000LLLLLLLLLLLLLLLLLL1
1LLLLLLLLLLLLLLLLLLLLL000000LLLLLLLLLLLLLLLLLL1
1LLLLLLLLLLLLLLLLLLLLL000000LLLLLLLLLLLLLLLLLL1
1LLLLLLLLLLLLLLLLLLLLL000000LLLLLLLLLLLLLLLLLL1
1LLLLLLLLLLLLLLLLLLLLL000000LLLLLLLLLLLLLLLLLL1
1LLLLLLLLLLLLLLLLLLLLL000000LLLLLLLLLLLLLLLLLL1
1LLLLLLLLLLLLLLLLLLLLL000000LLLLLLLLLLLLLLLLLL1
1LLLLLLLLLLLLLLLLLLLLL000000LLLLLLLLLLLLLLLLLL1
1LLLLLLLLLLLLLLLLLLLLL000000LLLLLLLLLLLLLLLLLL1
111111111111111111111100000011111111111111111111
1BBBBBBBB000000000000000000000000BBBBBBBBBBBBB1
1BBBBBBBB000000000000000000000000BBBBBBBBBBBBB1
1BBBBBBBB000000000000000000000000BBBBBBBBBBBBB1
1BBBBBBBB000000000000000000000000BBBBBBBBBBBBB1
1BBBBBBBB000000000000000000000000BBBBBBBBBBBBB1
1BBBBBBBB000000000000000000000000BBBBBBBBBBBBB1
1BBBBBBBB000000000000000000000000BBBBBBBBBBBBB1
1BBBBBBBB000000000000000000000000BBBBBBBBBBBBB1
1BBBBBBBB000000000000000000000000BBBBBBBBBBBBB1
1BBBBBBBB000000000000000000000000BBBBBBBBBBBBB1
1BBBBBBBB000000000000000000000000BBBBBBBBBBBBB1
1BBBBBBBB000000000000000000000000BBBBBBBBBBBBB1
1BBBBBBBB000000000000000000000000BBBBBBBBBBBBB1
1BBBBBBBB000000000000000000000000BBBBBBBBBBBBB1
1BBBBBBBB000000000000000000000000BBBBBBBBBBBBB1
11111111111111111111000111111111111111111111111
10000000001111100000000000011111000000000000001
10111111101000101111111111010001011111111111001
10100000101000101000000001010001010000000001001
10101110101011101011111101011101010111111101001
10101000101000001010000101000001010100000101001
10101011101111111010110101111111010101110101001
10101010000000001010100100000001010101000101001
10101010111111101010101111111101010101011101001
10100010100000101000100000000101000101000001001
11111010101110101111101111110101111101011111001
10000010101000100000001000000100000101000000001
10111110101011111111101011111111110101111111001
10100000101000000000101010000000000101000001001
10101111101111111110101110111111111101011101001
10101000000000000000100000100000000001010001001
10101011111111111111111110111111111111010111001
10101010000000000000000000000000000000010000001
10101111111111111111111111111111111111111111001
111111111111111111111111111111111111111L1111111